1111111111111111
100C000000000001
1011100011111001
100100E000001C01
10P0100011001111
10001C0000100001
10001110001000C1
1111111111111111
